**************************
*...............**********
*.*.*************........*
*.*...............*.**.*.*
*.*****.***********.**.*.*
*.....*.****........**.*.*
*.*.***......*****.***.*.*
*.*.....*.*.**.....***.*.*
*.***.*.*.**************.*
*.....*.*................*
*******.*.********.***.***
*..*..*.*......***.*...*.*
*.**.**.***.*.**.*.*****.*
*...........*....*.......*
**************************